segment	片段
History Completion	历史完成
History Prediction	历史预测
term	词汇	词汇表中的条目
Glossary	词汇表
shortcut	缩略词	在autotext功能中出现，可以输入缩略词，自动补全单词。比如输入ad.补全为advertisement
shortcut	快捷方式	快捷键相关处使用。
shortcut	快捷键
Preferences	首选项
Change	修改
domain	领域	查询TaaS术语时可以选择特定的领域
API Key	API 密钥	专业名词就不翻译了
spreadsheet	电子表格
Drag and drop	拖放
bidirectional control characters	双向控制字符
Auto-Populated	自动填充
Note	备注
comment	注释
pre-configured	预配置
auto-complete	自动完成
Context Menu	右键菜单
Delimiter	分隔符
Shortcut	快捷键
Non-breaking space	不换行空格	简称NBSP
tarball	tarball	一种压缩文件格式，直接用英文就可以了
DeepL	DeepL	专有名词
uncheck	取消勾选	一般搭配box，取消勾选某中选框
repository	存储库
Stripper	脱壳	计算机软件里一段专门负责保护软件不被非法修改或反编译的程序。
regular expression	正则表达式
Editor	编辑器
pane	窗格
Whitespace	空白字符	包括各种显示为“空白”的字符，比如空格、tab(\t)、不换行空格（nbsp），等等。
tokenizer	分词器
fuzzy	模糊
OmegaT	OmegaT
library	库
project	项目
GUI	图形界面	完整翻译应当是“图形用户界面”，使用习惯中文。
URL	网址
team	团队	和git/svn项目有关时。
user group	用户组
Lead developer	首席开发人员
Bug	Bug	特定名词无特别好的中译干脆不翻译，注意大小写。
feature request	功能建议
Tracking system	跟踪系统
social network	社交网络
Instant Start Guide	快速入门指南
HOWTO	指南
Howto	指南
file filter	文件过滤器
Web Start	Web Start	java的专有名词，不翻译。
Open Document Format	OpenDocument 格式	统一专有名词的呈现。
leading	开头
trailing	末尾
LanguageTools	LanguageTool	软件名称，后面多了s应当是笔误？
